....................
...GS...........X...
...--..G.......--...
....G.--.......SG...
...--..........--...
...GS.....G....G....
...--....--....--...
....G..........SG...
...--........G.--...
...GS.......--.G....
...--..........--...
....G..........SG...
...--..........--...
.1........Z.........
####################
